DANE WEJSCIOWE (Zadanie 4 - A*)
Legenda: . piasek | # skala | X krater | S start | G cel
Zroznicowane koszty wjazdu: piasek=2.0, skala=6.0, obrot=0.5

X.#.#..####.........
#X##..X#..#...#..#..
..##...###...##.##.#
.#.#.##.##......#..X
.#.XX.#..#.##.....X.
###.X##..#....#..#.#
###X......#.X...#.XX
.....##.#.#...####..
....#.#...#....X##.#
.XX#XX....X...XX.#..
.....X...S#.X.#X#XX.
.....X#.......###.#.
#....#X...#....#..##
.#G....##......#..##
#.....X#....#.....X.

Start = (9,10),  Cel = (2,13)
